+--+--+--+--+--+--+--+--+--+--+--+--+--+
|     |        |  |  |        |  |     |
+  +  +  +--+  +  +  +  +--+  +  +  +--+
|  |  |     |  |  |  |  |  |  |  |  |  |
+  +--+  +  +  +  +  +  +  +  +  +  +  +
|     |  |  |  |     |  |  |  |  |     |
+--+  +  +  +  +  +  +--+  +  +  +--+  +
|  |  |     |  |     |  |  |     |  |  |
+  +  +  +--+  +  +--+  +  +--+  +  +--+
|  |     |  |  |  |     |  |  |  |     |
+  +--+  +  +  +--+  +  +  +--+  +--+  +
|  |     |     |     |  |  |  |  |     |
+  +  +--+  +--+  +--+  +--+  +  +--+  +
|  |     |  |     |  |  |  |  |  |  |  |
+--+  +  +  +  +  +  +--+  +  +  +--+  +
|  |  |  |  |     |     |  |  |     |  |
+  +  +  +--+  +  +  +  +--+  +--+  +  +
|  |  |     |  |  |  |  |  |  |  |  |  |
+  +  +--+  +  +  +  +  +  +  +  +--+  +
|  |        |  |  |  |  |  |        |  |
+--+  +--+  +  +  +  +  +  +  +--+  +--+
|  |     |  |  |  |  |  |  |  |  |   g |
+--+--+--+--+--+--+--+--+--+--+--+--+--+
